.o#.##.....#..#
.o#.#........#.
.ooo#.....#..#.
...ooooooooooo.
....###...#.#o.
...#.......#.o.
..#.......#..o#
#............o.
#.........##.o.
........#....o.
.#.#....#..##o#
.....#.......oo
.#.#..#.###..#o
....#.#...#...o
#....#.#..###..
