..#.##.....#..#
o.#.#........#.
o...#.....#..#.
o..............
o...###...#.#..
o..#.......#...
oo#.......#...#
#o.............
#o........##...
.oooo...#......
.#.#ooo.#..##.#
.....#oooooo...
.#.#..#.###o.#.
....#.#...#ooo.
#....#.#..###o.
